   111212334441  11222333  11111
   11112221112322333311233112444
   12233141412411111111223124444
   11 11 11 11 11 11 11 11 11 11
   11111111111111111111111111111
   21212121212121212121212121212
   12121212121212121212121212121
   